prs=Afghanistan Persian
af=Afrikaans
sq=Albanian
am=Amharic
ar=Arabic
hy=Armenian
as=Assamese
ast=Asturian
az=Azerbaijani
ms=Bahasa Malaysia
eu=Basque
be=Belarusian
bn=Bengali
bs=Bosnian
bg=Bulgarian
my=Burmese
ca=Catalan
zh-hans=Chinese, Simplified
zh-hant=Chinese, Traditional
hr=Croatian
cs=Czech
da=Danish
nl=Dutch
dz=Dzongkha
en-gb=English, British
eo=Esperanto
et=Estonian
fo=Faeroese
fil=Filipino
fi=Finnish
fr=French
fy=Frisian, Western
gl=Galician
ka=Georgian
de=German
el=Greek
gu=Gujarati
ht=Haitian Creole
he=Hebrew
hi=Hindi
zh-hk=Hong Kong Cantonese
hu=Hungarian
is=Icelandic
id=Indonesian
ga=Irish
it=Italian
ja=Japanese
jv=Javanese
kn=Kannada
kk=Kazakh
km=Khmer
rw=Kinyarwanda
ko=Korean
ku=Kurdish
ky=Kyrgyz
lo=Lao
lv=Latvian
lt=Lithuanian
xx-lolspeak=Lolspeak
lb=Luxembourgish
mk=Macedonian
mg=Malagasy
ml=Malayalam
mt=Maltese
mi=Maori
mr=Marathi
mfe=Mauritian Creole
mn=Mongolian
ne=Nepali
se=Northern Sami
nb=Norwegian Bokm√•l
nn=Norwegian Nynorsk
oc=Occitan
or=Oriya
os=Ossetian
ps=Pashto
fa=Persian, Farsi
pl=Polish
pt-br=Portuguese, Brazil
pt=Portuguese, International
pt-pt=Portuguese, Portugal
pa=Punjabi
rhg=Rohingya
ro=Romanian
ru=Russian
sco=Scots
gd=Scots Gaelic
sr=Serbian
sd=Sindhi
si=Sinhala
sk=Slovak
sl=Slovenian
so=Somali
es=Spanish
sw=Swahili
sv=Swedish
gsw-berne=Swiss German
ta=Tamil
ta-lk=Tamil, Sri Lanka
te=Telugu
test=Test
th=Thai
bo=Tibetan
ti=Tigrinya
tr=Turkish
tyv=Tuvan
ug=Uighur
uk=Ukrainian
ur=Urdu
vi=Vietnamese
cy=Welsh
yi=Yiddish
